-------------------------------------------------------------------------------------------------------------------------------------------------------------------------------------------------------------------------
-----------------------------M-----------X-------------------------XXX---------------------------------------------------------------------------------------------------------------------------------------------------
-------------------XX--------------------------------------------------X--------------------------------------------------------------------------------------------------------M----------------------------------------
------------------XXXX---------------------------------------------------X-------------------------------------------------------------------------XXXXX-------XX---------XX---------------------------------------------
-----------------XXXXXX---------------X------------------------X-----------X--------------------------------XXXXXXXXXXX---------------------------XXXXXX---X---------X---------------------------------------------------
----------------XXXXXXXX-----------------------------------------------------XXXXX--------------------------------M------------------------------XX----------------------------------------------------------------------
---------------XXXXXXXXXX-----------------------------------------------------------------XXXXXX------------XXXXXXXXXXX-------------------------XX-----------------------------------------------------------------------
--------------XXXXXXXXXXXX----------------------------------------------------------------------------------XXXXXXXXXXX--------------------------------------------------------------------------------------------------
-------C-----XXXXXXXXXXXXXX--------X-----------X-C----------X-------------------------------------C------------------------C-------------------------------------------------------------------E-------------------------
XXXXXXXXXXXXXXXXXXXXXXXXXXXXXXXXXXXX-----------XXXXXXXXXXXXXX-----------------M------------------XXXXXXXXXXXXXXXXXXXXXXXXXXXXXXXXXX-X-X-X-X-X-X-X-X-X-X-X-X-X-X-X-X-X-X-X-X-X-X-XXXXXXXXXXXXXXXXXXXXXXXXXXXXXXXXXXXXXXXXX
XXXXXXXXXXXXXXXXXXXXXXXXXXXXXXXXXXXX-----------XXXXXXXXXXXXXX-X-X-X-X-X-X-X-X-XXXXX---X----------XXXXXXXXXXXXXXXXXXXXXXXXXXXXXXXXXX---------------------------------------------XXXXXXXXXXXXXXXXXXXXXXXXXXXXXXXXXXXXXXXXX
XXXXXXXXXXXXXXXXXXXXXXXXXXXXXXXXXXXX-----------XXXXXXXXXXXXXX-X-X-X-X-X-X-X-X-XXXXX--------------XXXXXXXXXXXXXXXXXXXXXXXXXXXXXXXXXX---------------------------------------------XXXXXXXXXXXXXXXXXXXXXXXXXXXXXXXXXXXXXXXXX