-----------------------------------------------------------------------------------------------------------------------------------------------------------------------------M---------------------------------------------------
--------------------------------------------------------------------------------------------------------------------------------------------------------XX---X---X---X---X---X---------------------------------------------------
------------------------------------------------------------M------------------------------------------------------------M----------------------------XXXX-----------------------------------------------------------------------
-----------------------------------------------------------XXXXXXXXX----------------------------------------------XXXXXXXXXX------------------------XXXXXX-----------------------------------------------------------------------
------------------------------------------------------X----XXXXXXXXX------------------------------------------------------------------------------XXXXXXXX-----------------------------------------------------------------------
-----------------------------------------------------XX----XXXXXXXXX-----------------------X----------------------------------------------------XXXXXXXXXX-----------------------------------------------------------------------
-------------------------------M--------------------XXX----XXXXXXXXX-------------------X---X---X------------------XXXXXXXXXX------------------XXXXXXXXXXXX-----------------------------------------------------------------------
----------------------XX---X---X---X---XX----------XXXX----XXXXXXXXX---------------X---X---X---X---X----------------------------------------XXXXXXXXXXXXXX-----------------------------------------------------------------------
-------C------------XXXX-------------- XXXX-------XXXXX---------------C--------X---X---X---X--MX---X---X----------------------------C-----XXXXXXXXXXXXXXXX----------------------------------------------E------------------------
XXXXXXXXXXXXXXXXXXXXXXXX---------------XXXXXXXXXXXXXXXXXXXXXXXXXXXXXXXXXXXXXXXXXXXXXXXXXXXXXXXXXXXXXXXXXXXXXXXXX--------------XXXXXXXXXXXXXXXXXXXXXXXXXXXX---XXX---XXX---XXX---XXX---XXX---XXXXXXXXXXXXXXXXXXXXXXXXXXXXXXXXXXXXXX
XXXXXXXXXXXXXXXXXXXXXXXX---------------XXXXXXXXXXXXXXXXXXXXXXXXXXXXXXXXXXXXXXXXXXXXXXXXXXXXXXXXXXXXXXXXXXXXXXXXX--------------XXXXXXXXXXXXXXXXXXXXXXXXXXXX---XXX---XXX---XXX---XXX---XXX---XXXXXXXXXXXXXXXXXXXXXXXXXXXXXXXXXXXXXX
XXXXXXXXXXXXXXXXXXXXXXXX---------------XXXXXXXXXXXXXXXXXXXXXXXXXXXXXXXXXXXXXXXXXXXXXXXXXXXXXXXXXXXXXXXXXXXXXXXXX--------------XXXXXXXXXXXXXXXXXXXXXXXXXXXX---XXX---XXX---XXX---XXX---XXX---XXXXXXXXXXXXXXXXXXXXXXXXXXXXXXXXXXXXXX