--------------------------------------------------------------------------------------------------------------------------------------------------------------------------------------------------------------------------
-------------------------------------------------------------------------------------------X-----------------X-----------------X----------------X-------------------------------------------------------------------------
---------------------------------M-------------M-------------M------------------------------------------------------------------------------------------------------------------------------------------------------------
---------------------------XXXXXXX--------XXXXXX--------XXXXXX-------------------------X----------------------------------------------------------------------------------------------------------------------------------
---------------------------------------------------------------------------------------------------------X-----------------X----------------X-----------------------------------------------------------------------------
---------------------------XXXXXXXX-------XXXXXXX-------XXXXXXX-----------------------------------------------------------------------------------------------------------------------------------------------------------
-----------------------------------------------------------------------------------XX----------------------------M-----------------M--------------------------------------------------------------------------------------
---------------------------------------------------------------------------------XXXX----------------X-----------------X----------------X---------------------------------------------------------------------------------
------------C-----------------------XX------------XX------------XX---C---------XXXXXX------------------------------------------------------------------------E------------------------------------------------------------
XXXXXXXXXXXXXXXXXXXXXXXX-------------------------------------------XXXXXXXXXXXXXXXXXX-------------------------------------------------------------XXXXXXXXXXXXXXXXXXXXXXXXXXXXXXXXXXXXXXXXXXXXXXXXXXXXXXXXXXXXXXXXXXXXXXXX
XXXXXXXXXXXXXXXXXXXXXXXX-------------------------------------------XXXXXXXXXXXXXXXXXX------------X-----------------X----------------X-------------XXXXXXXXXXXXXXXXXXXXXXXXXXXXXXXXXXXXXXXXXXXXXXXXXXXXXXXXXXXXXXXXXXXXXXXX
XXXXXXXXXXXXXXXXXXXXXXXX-------------------------------------------XXXXXXXXXXXXXXXXXX-------------------------------------------------------------XXXXXXXXXXXXXXXXXXXXXXXXXXXXXXXXXXXXXXXXXXXXXXXXXXXXXXXXXXXXXXXXXXXXXXXX