------------------------------------------------------------------------------------------------------------------------------------------------------------M---------------------------------------------------------------------------------------------
-------------------------------------------------------------------------------------------------------M---------------------XXXXXXXXXXXXXXXXXXXXXXXXXXXXXXXX----------------X------------X------------X------------X-------------------------------------
-----------------------M------------------------------------------------------------------------------------------------------------------------------------X---------------X-X----------X-X----------X-X----------X-X------------------------------------
-------------------XXXXXXXXX-------------------------------------------------------------------------------------------------XXXXXXXXXXXXXXXXXXXXXXXXXXXXXXXX--------------X---X-X-XX-X-X---X-X-XX-X-X---X-X-XX-X-X---X-----------------------------------
------------------XXXXXXXXXX------------------------------------------XXXXXXXXXXXXXXXXXXXXXXXXXXXXXX-------------------------XXXXXXXXXXXXXXXXXXXXXXXXXXXXXXXX-------------X-------------------------------------------------------------------------------
-----------------XXXXXXXXXXX----XXXX----------------------------------------------------------------------------------------------------------------------------------XXXXX-------------------------------------------------------------------------------
----------------XXXXXXXXXXXX----XXXXX---XX----------------------------XXXXXXXXXXXXXXXXXXXXXXXXXXXXXX------------XXXXXXXXXXXXXXXXXXXXXXXXXXXXXXXXXXXXXXXXXXXXX-------------------------------------------------------------------------------------------
---------------XXXXXXXXXXXXX----XXXXX---XXXX---X----------------------XXXXXXXXXXXXXXXXXXXXXXXXXXXXXX-----------XXXXXXXXXXXXXXXXXXXXXXXXXXXXXXXXXXXXXXXXXXXXXX---------------------------------------------------------------------------------------------
-------C------XXXXXXXXXXXXXX----XXXXX---XXXX---XXXX-----C---------------------------------------XXXX----------XXXXXXXXXXXXXXXXXXXXXXXXXXXXXXXXXXXXXXXXXXXXXXX--C-------------------------------------------------------------------------E----------------
XXXXXXXXXXXXXXXXXXXXXXXXXXXX-----XXXX---XXXX---XXXX----XXXXXXXXXXXXXXXXXXXXXXXXXXXXXXXXXXX------XXXXXXXXXXXXXXXXXXXXXXXXXXXXXXXXXXXXXXXXXXXXXXXXXXXXXXXXXXXXXXXXXXXXXXXXXXX-------------------------------------------XXXXXXXXXXXXXXXXXXXXXXXXXXXXXXXXXXXX
XXXXXXXXXXXXXXXXXXXXXXXXXXXX-----M---------------------XXXXXXXXXXXXXXXXXXXXXXXXXXXXXXXXXXX------XXXXXXXXXXXXXXXXXXXXXXXXXXXXXXXXXXXXXXXXXXXXXXXXXXXXXXXXXXXXXXXXXXXXXXXXXXXX--------------------------------------M-XXXXXXXXXXXXXXXXXXXXXXXXXXXXXXXXXXXXXX
XXXXXXXXXXXXXXXXXXXXXXXXXXXX----XXXXXXXXXXXXXXXXXXXXXXXXXXXXXXXXXXXXXXXXXXXXXXXXXXXXXXXXXX------XXXXXXXXXXXXXXXXXXXXXXXXXXXXXXXXXXXXXXXXXXXXXXXXXXXXXXXXXXXXXXXXXXXXXXXXXXXXXXX----X----X----X----X----X----X----XXXXXXXXXXXXXXXXXXXXXXXXXXXXXXXXXXXXXXXXX