------------------------------------------------------------------------------------------------------------M----------------------------------------------------M--------------------------------------------------------------------------------------------------
---------------------------------------------------------------------------------XXXXXXXXXXXXXXXXXXXXXXXXXXXX--------------------------------XXXXXXXXXXXXXXXX-------------------------------------------------------------------------------------------------------
--------------------------------------------------------M---------------------------------------------------X---------------------------XX----XXXXXXXXXXXXXXX----------------------XXX-----------XXX----------------------------------XX-----M----------------------
------------------------XXXXXXXX------------------------X------------------------XXXXXXXXXXXXXXXXXXXXXXXXXXXX-----------------------------X----XXXXXXXXXXXXXX--------------------XXX--------------------------------------------------------------------------------
---------------------------------------------------------------------------------XXXXXXXXXXXXXXXXXXXXXXXXXXXX----------------------XX------X----XXXXXXXXXXXXX------------------XXX---------------XXXX---------------------------------------------------------------
----------------------------------X-------X----X----X---------------------XXX----XXXXXXXXXXXXXXXXXXXXXXXXXXXX-------------------------------X----XXXXXXXXXXXX----------------XXX--------------------------------------------------X---------------------------------
--------------------X-----------------X----------------------------------XXXX-------------------------------X------------------X-------------X----XXXXXXXXXXX--------------XXX--------------------------------------------------------------------------------------
------------------------------------------------------------------------XXXXX-------------------------------X---------------------------------X----XXXXXXXXXX------------XXX---------------XX---------------------X----------X-------------------------------------
-------C--------X----------------------------------------------C-------XXXXXX------XXXXXXXXXXXXXXXXXXXXXXXXXX-------C-----XX-------------------X----XXXXXXXXX-C--------XXX----------------------------------------------X----------------------------E--------------
XXXXXXXXXXXXXXX--------------------------------------------XXXXXXXXXXXXXXXXXX------XXXXXXXXXXXXXXXXXXXXXXXXXX----XXXXXXXXXXX--------------------X----XXXXXXXXXXXXXX----XXXXXXXXX------------------------------X-----------------------------XXXXXXXXXXX-------------
XXXXXXXXXXXXXXX--------------------------------------------XXXXXXXXXXXXXXXXXX-------------------------------X----XXXXXXXXXXX---------------------X------------------------XXXXXX----------------------C-------------------------------------------------------------
XXXXXXXXXXXXXXX--------------------------------------------XXXXXXXXXXXXXXXXXXXXXXXXXXXXXXXXXXXXXXXXXXXXXXXXXXXXXXXXXXXXXXXXX----------------------XXXXXXXXXXXXXXXXXXXXXXXXXXXXXX----------------------XXXXXX---------------------------------------------------------